9
16
B000000000000000
B000000000000000
BB00R0000B000000
0000R0000B000000
0000R0000B0000OA
R00B00BBR0RRRR00
0000000000000000
0000000000000000
0000000000000000