9
16
0000000000000000
0000000000000000
0000000000000000
00RRR0R0BBBBB000
0000000R0B000000
0000000000000A00
0000000000000000
RRRRRRRRBBBBBBBB
0000000000000000