9
16
0000000000000000
0000000000000000
00R0000000000B00
00R0000000000B00
0RR0000OA0000BB0
0RR000R00B000BB0
0RRRRR0000BBBBB0
0000000000000000
0000000000000000