9
16
0000B00000000000
0000BBB000000000
0000B00B00000000
0000000R00B00000
BBBRR00R00B00000
000000RR000000GA
000BB00B0R0BB000
0000000000000000
0000000000000000